q	ゅ
w		か
e		し
r		て
t	ょ
y		つ
u	ん
i	い
o	゛
p		ち
@	ー
-	ー

a		は
s		こ
f		と
g		た
h		く
j		う
l	の
;		き
:	ー

z		す
x		ふ
c		せ
v	な
b		さ
n	っ
m	る
,	、
.	。
/	゜

k		d
dq	ゆ
dw	ゃ
de		ひ
dr		へ
dt	め
dy	む
du	え
di	り
do	み
dp	ぬ
d-	れ
d@	れ

da		ほ
ds	も
dd	ら
df	お
dg	あ
dh		け
dj	ま
dk	に
dl	を
d;	ね
d:	ゃ

dz	ぁ
dx	ぃ
dc		そ
dv	よ
db	や
dn	わ
dm	ろ
d,	ぅ
d.	ぇ
d/	ぉ


うo	ヴ
かo	が
きo	ぎ
くo	ぐ
けo	げ
こo	ご
さo	ざ
しo	じ
すo	ず
せo	ぜ
そo	ぞ
たo	だ
ちo	ぢ
つo	づ
てo	で
とo	ど
はo	ば
ひo	び
ふo	ぶ
へo	べ
ほo	ぼ

は/	ぱ
ひ/	ぴ
ふ/	ぷ
へ/	ぺ
ほ/	ぽ
い/	ゐ
え/	ゑ
か/	ヵ
け/	ヶ
わ/	ゎ
